NO imgs/lol
SO imgs/lil
EA imgs/lal
WE imgs/lal

F 0,204,0
C 147,113,219

11111111111
10000B00P01
10001010P01
10000001001
1000W000101
10000000001
11111111111
