NO imgs/lol
SO imgs/lil
EA imgs/lal
WE imgs/lal

F 0,204,0
C 147,113,219

1111111111111
10000B00P001
1000000P001
10W00001001
10000000101
10000000001
11111111111
