NO imgs/N.xpm
SO imgs/S.xpm
EA imgs/E.xpm
WE imgs/O.xpm

F 0,136,209
C 255,188,219

11111111111
10100000001
110000P0P01
10000000001
10000000B01
10000N00001
11111111111
