NO imgs/lol
SO imgs/lil
EA imgs/lal
WE imgs/lal


F 0,204,0
C 147,112,219

11111111111
1000B00P001
1000000P001
1000E001001
10000000101
10000000001
11111111111
