F 9,98,65

NO imgs/lol
SO imgs/salut
EA imgs/lal
WE imgs/lal


C 21,8,6
















                                    
  1111111111  11111111
 10000000001  100000001 
 111111100001100000011
     100000000111111     1
 1111111100000000111111110111
 10000000000000000000000000001
 1000000000000000011111110011111111111111111111
 11111111111111111       11
  
   
      
          
   
111111
1000E01
1111111
