NO imgs/N.xpm
SO imgs/S.xpm
EA imgs/E.xpm
WE imgs/O.xpm

F 122,125,135
C 255,188,219

11111111111
101H0000001
110000P0P01
10000000001
10000000B01
1X000W00001
11111111111
