NO imgs/N.xpm
SO imgs/S.xpm
EA imgs/E.xpm
WE imgs/O.xpm

C 122,206,255
F 57,82,89

11111111111
101H0H00001
110000P0P01
10000000001
10000000B01
100X0W00001
11111111111
