NO imgs/N.xpm
SO imgs/S.xpm
EA imgs/E.xpm
WE imgs/O.xpm

C 122,206,255
F 57,82,89

11111111111
10100000001
11000000011
10000N00001
10000000001
10000010001
11111111111
