NO imgs/1.xpm
SO imgs/2.xpm
EA imgs/3.xpm
WE imgs/4.xpm

C 10,100,200
F 60,60,60

        1111111111111111111111111
        1000000000110000000000001
        1011000001110000000000001
        1001000000000000000000001
111111111011000001110000000000001
10000000001100000111PB11111111111111111
111101111111110111000000000000000000001
111101111111110111010000100000000000001
11000000110101011100N000100000000000001
100000000000000000000000001100000010001
100000000000000000000000001100000010001
100000000000000011000000000000000010001
100000000000000011000000100000000000001
100000000000000000000000001100000010001
100000000000000000000000001100000010001
100000000000000000000000001101010010001
100000000000000000000000001101010010001
100000000000000000000000001101010010001
100000000000000000000000001101010010001
100000000000000000000000001101010010001
100000000000000011010000000000010010001
1100000111010101111101111000000000000111
11110111 1110101 1011110100000000000001
11111111 1111111 1111111111111111111111
