WE ./imgs/Ouest.xpm
EA ./imgs/Est.xpm
NO ./imgs/Nord.xpm
SO ./imgs/Sud.xpm


C 163,198,199
F 106,122,122

         1111111
         1000001
         1000001
         1000001
111111111B0000001
1H000000P0000N0001
1111111111000000001
          1000000001
           11111111
