WE ./imgs/1.xpm
EA ./imgs/2.xpm
NO ./imgs/3.xpm
SO ./imgs/4.xpm


C 91,138,140
F 60,60,60

         1111111
         1E00001
         11111H1
         1000001
11111111111HH1111
1XH000000P000H00H1
111111111100010HHH1
        10H010HHHHB1
         1111111111
