NO imgs/1.xpm
SO imgs/2.xpm
EA imgs/3.xpm
WE imgs/4.xpm

C 91,138,140
F 60,60,60

111111111    111
10S11000011110H1
100100100000H001
1001H1001000H001
1001001001001111
1HH10001H000H001
100111P1001110H1
10000H0B101111X1
1111111111    1
