NO imgs/1.xpm
SO imgs/2.xpm
EA imgs/3.xpm
WE imgs/4.xpm

C 91,138,140
F 60,60,60

111111111    111
1001100001111001
100000000000H001
1000N0000000H001
1000000000001111
1HH000000000P001
1HHHH000001B10H1
1HHHHH01101111X1
1111111111    1
